NEMA_IQ	Abstract	box
NEMA_IQ_cold	Abstract	box
outershell1	Plastic	cylinder
upperinterior	Water	cylinder
centercyl	Plastic	cylinder
centercylin	Air	cylinder
sphere10	Plastic	sphare
sphere10in	Water	sphare
fill10	Plastic	cylinder
fill10in	Water	cylinder
sphere13	Plastic	sphare
sphere13in	Water	sphare
fill13	Plastic	cylinder
fill13in	Water	cylinder
sphere17	Plastic	sphare
sphere17in	Water	sphare
fill17	Plastic	cylinder
fill17in	Water	cylinder
sphere37	Plastic	sphare
sphere37in	Air	sphare
fill37	Plastic	cylinder
fill37in	Air	cylinder
topshell1	Plastic	cylinder
bottomshell1	Plastic	cylinder
outershell2	Plastic	cylinder
LLinterior	Water	cylinder
outershell3	Plastic	cylinder
LRinterior	Water	cylinder
outershell4	Plastic	box
boxinterior	Water	box
sphere22	Plastic	sphare
sphere22in	Water	sphare
fill22	Plastic	cylinder
fill22in	Water	cylinder
sphere28	Plastic	sphare
sphere28in	Air	sphare
fill28	Plastic	cylinder
fill28in	Air	cylinder
topshell2	Plastic	cylinder
topshell3	Plastic	cylinder
topshell4	Plastic	box
bottomshell2	Plastic	cylinder
bottomshell3	Plastic	cylinder
bottomshell4	Plastic	box
